################################################################################
#                    #   ##                                                    #
#                    ###########################################################
#                    #                                                         #
#                    +                                                         #
#                    ###+##################   ##################################
######################                    #   #                  #             #
#                    #                    #   +                  +             #
#                    #                    #   #                  #             #
#                    #                    #   ####################             #
#                    +                    #   #                  #             #
#                    #                    +   +                  #             #
#                    #                    #   #                  #             #
###########################################   #                  #             #
#                    #                    #   #                  #             #
#                    +                    +   #                  #             #
#                    #                    #   #                  ###############
#                    #                    #   #                  #             #
#                    ######################   ####################             #
#                    #                                           #             #
#                    +                                           +             #
#                    #                                           #             #
################################################################################
